abvate : reveal
bal : yes
banch : eye
beckle : shudder
blide : fully-charged
boltep : peel
bommly : negative
brangy : ground
brolge : hint
calbice : shell
camling : minute
chalm : sign
chender : receptacle
coyd : selector
cren : stick
curple : entryway
da : no
dape : verb
darf : darf
darftunder : darf-creater
dass : bad
deave : exist
dedge : command
degomb : exit
disbosh : response
discren : unstick
disengope : shrink
dislello : open
disgask : discharge
disrask : drop
distim : brighten
distunk : ignore
doatch : speak
dobbly : fancy
dosh : dosh
droke : droke
dugrid : top
durch : use
durl : strong
engope : enlarge
fargish : give
fesh : purpose
feshary : library
flome : sound
fosk : canopy
fosken : away
frike : fly
gask : charge
gemmly : positive
gharmy : upset
gheliper : gheliper
gitch : gitch
glake : attack
glaud : glaud
gnurr : succeed
goave : tooth
gomb : enter
gomway : path
gope : large
gopest : largest
gurr : near
halpock : game
heam : use
heamy : useful
interofgan : interactive
jallon : menu
leil : eat
lello : close
louk : type
lutt : exit
malk : bite
mavrous : massive
mislouk : mistype
mosky : quiet
motch : cover
murgous : powerful
musny : message
naft : group
nurl : whine
osta : previous
pell : move
plave : animal
plazzy : next
pob : drop
poltive : alive
rask : hold
reb : detect
reggle : unlock
regomb : reenter
relouk : retype
rike : set
roggle : lock
rorm : nice
scurm : awful
shamtag : shamtag
shoracle : attached
smarch : laugh
smib : dissolve
snave : good
snavest : best
skade : tone
skobe : open
skunge : smell
stam : fond
stike : barrier
stin : weak
sweff : match
tavid : hard
tavidlouk : hardtype
thale : empty
tophth : darken
tund : create
tunk : examine
uncren : unstick
unheamy : useless
ungope : small
unleilable : inedible
unzankable : unkillable
vold : frighten
vorl : protect
warb : warb
zank : kill
zoncha : rest

~~~~~DIRECTIONS~~~~~~
loff : north
jiloff : northeast
jirf : east
jihoff : southeast
hoff : south
kihoff : southwest
kirf : west
kiloff : northwest

~~~~~WORKAROUNDS~~~~~~
abvat : reveal
deav : exist
drok : speak
flom : sound
frik : fly
glak : attack
glaud-with-roggler : glaud-with-lock-er
rik : set